1111111
1100001
1P00001
1010001
1000001
10000C1
10000X1
1111001
1C000E1
1111111