111111111111111111111
100000110000000000001
1000C0100000000000001
100000100000000000001
100000100P001000001
1000C000000C1000C0001
10000000C000100000001
100000000000100000111
10000E0000001000000C1
111111111111111111111