1111111111111111111111111111111111111111111111111111
1000001100000000000000000000000000000000000000000001
1000C01000000000000010000000000000000000000000000001
1000001000000000000010000000000000000000000000000001
100000100P001000000010000000000000000000000000000001
1000C000000C1000C00010000000000000000000000000000001
10000000C0001000000010000000000000000000000000000001
1000000000001000001110000000000000000000000000000001
10000E0000001000000C10000000000000000000000000000001
1111111111111111111111111111111111111111111111111111