111111111111111111111
100000110000000000001
1000C0100000001000001
100000100000010100001
100000100P00100000001
1000C000000C1000C0001
10000010C000100000001
100000011000100000111
10000E0000001000000C1
111111111111111111111