111111111111111111111
10000X1100X0000000X01
1010C0000000001000001
1P1000100000010100001
101000100000100000001
1C10C010000C1000C0001
10100010C00X100000001
100000111000100000111
10000E1000001000000C1
111111111111111111111