1111111
10000X1
1010001
1P10001
1010C01
1010001
10C00E1
1111111