11111111
10000X11
1010C011
1P100011
10100011
1C10C011
10000E11
11111111