1111111
10000X1
1010C01
1P10001
1010001
1C10C01
10000E1
1111111