111111111111111111111
100000110000000000001
1010C0100000001000001
1P1000100000010100001
101000100000100000001
1010C000000C1000C0001
10100010C000100000001
100000011000100000111
10000E0000001000000C1
111111111111111111111